aaa	aaa	generic
aarp	aarp	generic
abarth	abarth	generic
abb	abb	generic
abbott	abbott	generic
abbvie	abbvie	generic
abc	abc	generic
able	able	generic
abogado	abogado	generic
abudhabi	abudhabi	generic
academy	academy	generic
accenture	accenture	generic
accountant	accountant	generic
accountants	accountants	generic
aco	aco	generic
actor	actor	generic
ads	ads	generic
adult	adult	generic
aeg	aeg	generic
aetna	aetna	generic
afl	afl	generic
africa	africa	generic
agakhan	agakhan	generic
agency	agency	generic
aig	aig	generic
airbus	airbus	generic
airforce	airforce	generic
airtel	airtel	generic
akdn	akdn	generic
alfaromeo	alfaromeo	generic
alibaba	alibaba	generic
alipay	alipay	generic
allfinanz	allfinanz	generic
allstate	allstate	generic
ally	ally	generic
alsace	alsace	generic
alstom	alstom	generic
amazon	amazon	generic
americanexpress	americanexpress	generic
americanfamily	americanfamily	generic
amex	amex	generic
amfam	amfam	generic
amica	amica	generic
amsterdam	amsterdam	generic
analytics	analytics	generic
android	android	generic
anquan	anquan	generic
anz	anz	generic
aol	aol	generic
apartments	apartments	generic
app	app	generic
apple	apple	generic
aquarelle	aquarelle	generic
arab	arab	generic
aramco	aramco	generic
archi	archi	generic
army	army	generic
art	art	generic
arte	arte	generic
asda	asda	generic
associates	associates	generic
athleta	athleta	generic
attorney	attorney	generic
auction	auction	generic
audi	audi	generic
audible	audible	generic
audio	audio	generic
auspost	auspost	generic
author	author	generic
auto	auto	generic
autos	autos	generic
avianca	avianca	generic
aws	aws	generic
axa	axa	generic
azure	azure	generic
baby	baby	generic
baidu	baidu	generic
banamex	banamex	generic
bananarepublic	bananarepublic	generic
band	band	generic
bank	bank	generic
bar	bar	generic
barcelona	barcelona	generic
barclaycard	barclaycard	generic
barclays	barclays	generic
barefoot	barefoot	generic
bargains	bargains	generic
baseball	baseball	generic
basketball	basketball	generic
bauhaus	bauhaus	generic
bayern	bayern	generic
bbc	bbc	generic
bbt	bbt	generic
bbva	bbva	generic
bcg	bcg	generic
bcn	bcn	generic
beats	beats	generic
beauty	beauty	generic
beer	beer	generic
bentley	bentley	generic
berlin	berlin	generic
best	best	generic
bestbuy	bestbuy	generic
bet	bet	generic
bharti	bharti	generic
bible	bible	generic
bid	bid	generic
bike	bike	generic
bing	bing	generic
bingo	bingo	generic
bio	bio	generic
black	black	generic
blackfriday	blackfriday	generic
blockbuster	blockbuster	generic
blog	blog	generic
bloomberg	bloomberg	generic
blue	blue	generic
bms	bms	generic
bmw	bmw	generic
bnpparibas	bnpparibas	generic
boats	boats	generic
boehringer	boehringer	generic
bofa	bofa	generic
bom	bom	generic
bond	bond	generic
boo	boo	generic
book	book	generic
booking	booking	generic
bosch	bosch	generic
bostik	bostik	generic
boston	boston	generic
bot	bot	generic
boutique	boutique	generic
box	box	generic
bradesco	bradesco	generic
bridgestone	bridgestone	generic
broadway	broadway	generic
broker	broker	generic
brother	brother	generic
brussels	brussels	generic
build	build	generic
builders	builders	generic
business	business	generic
buy	buy	generic
buzz	buzz	generic
bzh	bzh	generic
cab	cab	generic
cafe	cafe	generic
cal	cal	generic
call	call	generic
calvinklein	calvinklein	generic
cam	cam	generic
camera	camera	generic
camp	camp	generic
canon	canon	generic
capetown	capetown	generic
capital	capital	generic
capitalone	capitalone	generic
caravan	caravan	generic
car	car	generic
cards	cards	generic
care	care	generic
career	career	generic
careers	careers	generic
cars	cars	generic
casa	casa	generic
case	case	generic
cash	cash	generic
casino	casino	generic
catering	catering	generic
catholic	catholic	generic
cba	cba	generic
cbn	cbn	generic
cbre	cbre	generic
cbs	cbs	generic
center	center	generic
ceo	ceo	generic
cern	cern	generic
cfa	cfa	generic
cfd	cfd	generic
chanel	chanel	generic
channel	channel	generic
charity	charity	generic
chase	chase	generic
chat	chat	generic
cheap	cheap	generic
chintai	chintai	generic
christmas	christmas	generic
chrome	chrome	generic
church	church	generic
cipriani	cipriani	generic
circle	circle	generic
cisco	cisco	generic
citadel	citadel	generic
citic	citic	generic
citi	citi	generic
city	city	generic
cityeats	cityeats	generic
claims	claims	generic
cleaning	cleaning	generic
click	click	generic
clinic	clinic	generic
clinique	clinique	generic
clothing	clothing	generic
cloud	cloud	generic
club	club	generic
clubmed	clubmed	generic
coach	coach	generic
codes	codes	generic
coffee	coffee	generic
college	college	generic
cologne	cologne	generic
comcast	comcast	generic
com	com	generic
commbank	commbank	generic
community	community	generic
company	company	generic
compare	compare	generic
computer	computer	generic
comsec	comsec	generic
condos	condos	generic
construction	construction	generic
consulting	consulting	generic
contact	contact	generic
contractors	contractors	generic
cookingchannel	cookingchannel	generic
cooking	cooking	generic
cool	cool	generic
corsica	corsica	generic
country	country	generic
coupon	coupon	generic
coupons	coupons	generic
courses	courses	generic
cpa	cpa	generic
creditcard	creditcard	generic
credit	credit	generic
creditunion	creditunion	generic
cricket	cricket	generic
crown	crown	generic
crs	crs	generic
cruise	cruise	generic
cruises	cruises	generic
cuisinella	cuisinella	generic
cymru	cymru	generic
cyou	cyou	generic
dabur	dabur	generic
dad	dad	generic
dance	dance	generic
data	data	generic
date	date	generic
dating	dating	generic
datsun	datsun	generic
day	day	generic
dclk	dclk	generic
dds	dds	generic
deal	deal	generic
dealer	dealer	generic
deals	deals	generic
degree	degree	generic
delivery	delivery	generic
dell	dell	generic
deloitte	deloitte	generic
delta	delta	generic
democrat	democrat	generic
dental	dental	generic
dentist	dentist	generic
desi	desi	generic
design	design	generic
dev	dev	generic
dhl	dhl	generic
diamonds	diamonds	generic
diet	diet	generic
digital	digital	generic
direct	direct	generic
directory	directory	generic
discount	discount	generic
discover	discover	generic
dish	dish	generic
diy	diy	generic
dnp	dnp	generic
docs	docs	generic
doctor	doctor	generic
dog	dog	generic
domains	domains	generic
dot	dot	generic
download	download	generic
drive	drive	generic
dtv	dtv	generic
dubai	dubai	generic
dunlop	dunlop	generic
dupont	dupont	generic
durban	durban	generic
dvag	dvag	generic
dvr	dvr	generic
earth	earth	generic
eat	eat	generic
eco	eco	generic
edeka	edeka	generic
education	education	generic
email	email	generic
emerck	emerck	generic
energy	energy	generic
engineer	engineer	generic
engineering	engineering	generic
enterprises	enterprises	generic
epson	epson	generic
equipment	equipment	generic
ericsson	ericsson	generic
erni	erni	generic
esq	esq	generic
estate	estate	generic
etisalat	etisalat	generic
eurovision	eurovision	generic
eus	eus	generic
events	events	generic
exchange	exchange	generic
expert	expert	generic
exposed	exposed	generic
express	express	generic
extraspace	extraspace	generic
fage	fage	generic
fail	fail	generic
fairwinds	fairwinds	generic
faith	faith	generic
family	family	generic
fan	fan	generic
fans	fans	generic
farmers	farmers	generic
farm	farm	generic
fashion	fashion	generic
fast	fast	generic
fedex	fedex	generic
feedback	feedback	generic
ferrari	ferrari	generic
ferrero	ferrero	generic
fiat	fiat	generic
fidelity	fidelity	generic
fido	fido	generic
film	film	generic
final	final	generic
finance	finance	generic
financial	financial	generic
fire	fire	generic
firestone	firestone	generic
firmdale	firmdale	generic
fish	fish	generic
fishing	fishing	generic
fit	fit	generic
fitness	fitness	generic
flickr	flickr	generic
flights	flights	generic
flir	flir	generic
florist	florist	generic
flowers	flowers	generic
fly	fly	generic
food	food	generic
foodnetwork	foodnetwork	generic
foo	foo	generic
football	football	generic
ford	ford	generic
forex	forex	generic
forsale	forsale	generic
forum	forum	generic
foundation	foundation	generic
fox	fox	generic
free	free	generic
fresenius	fresenius	generic
frl	frl	generic
frogans	frogans	generic
frontdoor	frontdoor	generic
frontier	frontier	generic
ftr	ftr	generic
fujitsu	fujitsu	generic
fund	fund	generic
fun	fun	generic
furniture	furniture	generic
futbol	futbol	generic
fyi	fyi	generic
gal	gal	generic
gallery	gallery	generic
gallo	gallo	generic
gallup	gallup	generic
game	game	generic
games	games	generic
gap	gap	generic
garden	garden	generic
gay	gay	generic
gbiz	gbiz	generic
gdn	gdn	generic
gea	gea	generic
gent	gent	generic
genting	genting	generic
george	george	generic
ggee	ggee	generic
gift	gift	generic
gifts	gifts	generic
gives	gives	generic
giving	giving	generic
glass	glass	generic
gle	gle	generic
global	global	generic
globo	globo	generic
gmail	gmail	generic
gmbh	gmbh	generic
gmo	gmo	generic
gmx	gmx	generic
godaddy	godaddy	generic
gold	gold	generic
goldpoint	goldpoint	generic
golf	golf	generic
goodyear	goodyear	generic
goog	goog	generic
google	google	generic
goo	goo	generic
gop	gop	generic
got	got	generic
grainger	grainger	generic
graphics	graphics	generic
gratis	gratis	generic
green	green	generic
gripe	gripe	generic
grocery	grocery	generic
group	group	generic
guardian	guardian	generic
gucci	gucci	generic
guge	guge	generic
guide	guide	generic
guitars	guitars	generic
guru	guru	generic
hair	hair	generic
hamburg	hamburg	generic
hangout	hangout	generic
haus	haus	generic
hbo	hbo	generic
hdfcbank	hdfcbank	generic
hdfc	hdfc	generic
healthcare	healthcare	generic
health	health	generic
help	help	generic
helsinki	helsinki	generic
here	here	generic
hermes	hermes	generic
hgtv	hgtv	generic
hiphop	hiphop	generic
hisamitsu	hisamitsu	generic
hitachi	hitachi	generic
hiv	hiv	generic
hkt	hkt	generic
hockey	hockey	generic
holdings	holdings	generic
holiday	holiday	generic
homedepot	homedepot	generic
homegoods	homegoods	generic
homesense	homesense	generic
homes	homes	generic
honda	honda	generic
horse	horse	generic
hospital	hospital	generic
host	host	generic
hosting	hosting	generic
hoteles	hoteles	generic
hotels	hotels	generic
hot	hot	generic
hotmail	hotmail	generic
house	house	generic
how	how	generic
hsbc	hsbc	generic
hughes	hughes	generic
hyatt	hyatt	generic
hyundai	hyundai	generic
ibm	ibm	generic
icbc	icbc	generic
ice	ice	generic
icu	icu	generic
ieee	ieee	generic
ifm	ifm	generic
ikano	ikano	generic
imamat	imamat	generic
imdb	imdb	generic
immobilien	immobilien	generic
immo	immo	generic
inc	inc	generic
industries	industries	generic
infiniti	infiniti	generic
info	info	generic
ing	ing	generic
ink	ink	generic
institute	institute	generic
insurance	insurance	generic
insure	insure	generic
international	international	generic
intuit	intuit	generic
investments	investments	generic
ipiranga	ipiranga	generic
irish	irish	generic
ismaili	ismaili	generic
istanbul	istanbul	generic
ist	ist	generic
itau	itau	generic
itv	itv	generic
jaguar	jaguar	generic
java	java	generic
jcb	jcb	generic
jeep	jeep	generic
jetzt	jetzt	generic
jewelry	jewelry	generic
jio	jio	generic
jll	jll	generic
jmp	jmp	generic
jnj	jnj	generic
joburg	joburg	generic
jot	jot	generic
joy	joy	generic
jpmorgan	jpmorgan	generic
jprs	jprs	generic
juegos	juegos	generic
juniper	juniper	generic
kaufen	kaufen	generic
kddi	kddi	generic
kerryhotels	kerryhotels	generic
kerrylogistics	kerrylogistics	generic
kerryproperties	kerryproperties	generic
kfh	kfh	generic
kia	kia	generic
kids	kids	generic
kim	kim	generic
kinder	kinder	generic
kindle	kindle	generic
kitchen	kitchen	generic
kiwi	kiwi	generic
koeln	koeln	generic
komatsu	komatsu	generic
kosher	kosher	generic
kpmg	kpmg	generic
kpn	kpn	generic
krd	krd	generic
kred	kred	generic
kuokgroup	kuokgroup	generic
kyoto	kyoto	generic
lacaixa	lacaixa	generic
lamborghini	lamborghini	generic
lamer	lamer	generic
lancaster	lancaster	generic
lancia	lancia	generic
land	land	generic
landrover	landrover	generic
lanxess	lanxess	generic
lasalle	lasalle	generic
latino	latino	generic
lat	lat	generic
latrobe	latrobe	generic
law	law	generic
lawyer	lawyer	generic
lds	lds	generic
lease	lease	generic
leclerc	leclerc	generic
lefrak	lefrak	generic
legal	legal	generic
lego	lego	generic
lexus	lexus	generic
lgbt	lgbt	generic
lidl	lidl	generic
lifeinsurance	lifeinsurance	generic
life	life	generic
lifestyle	lifestyle	generic
lighting	lighting	generic
like	like	generic
lilly	lilly	generic
limited	limited	generic
limo	limo	generic
lincoln	lincoln	generic
linde	linde	generic
link	link	generic
lipsy	lipsy	generic
live	live	generic
living	living	generic
llc	llc	generic
llp	llp	generic
loan	loan	generic
loans	loans	generic
locker	locker	generic
locus	locus	generic
lol	lol	generic
london	london	generic
lotte	lotte	generic
lotto	lotto	generic
love	love	generic
lplfinancial	lplfinancial	generic
lpl	lpl	generic
ltda	ltda	generic
ltd	ltd	generic
lundbeck	lundbeck	generic
luxe	luxe	generic
luxury	luxury	generic
macys	macys	generic
madrid	madrid	generic
maif	maif	generic
maison	maison	generic
makeup	makeup	generic
management	management	generic
mango	mango	generic
man	man	generic
map	map	generic
marketing	marketing	generic
market	market	generic
markets	markets	generic
marriott	marriott	generic
marshalls	marshalls	generic
maserati	maserati	generic
mattel	mattel	generic
mba	mba	generic
mckinsey	mckinsey	generic
media	media	generic
med	med	generic
meet	meet	generic
melbourne	melbourne	generic
meme	meme	generic
memorial	memorial	generic
men	men	generic
menu	menu	generic
merckmsd	merckmsd	generic
miami	miami	generic
microsoft	microsoft	generic
mini	mini	generic
mint	mint	generic
mit	mit	generic
mitsubishi	mitsubishi	generic
mlb	mlb	generic
mls	mls	generic
mma	mma	generic
mobile	mobile	generic
mobi	mobi	generic
moda	moda	generic
moe	moe	generic
moi	moi	generic
mom	mom	generic
monash	monash	generic
money	money	generic
monster	monster	generic
mormon	mormon	generic
mortgage	mortgage	generic
moscow	moscow	generic
moto	moto	generic
motorcycles	motorcycles	generic
movie	movie	generic
mov	mov	generic
msd	msd	generic
mtn	mtn	generic
mtr	mtr	generic
music	music	generic
mutual	mutual	generic
nab	nab	generic
nagoya	nagoya	generic
natura	natura	generic
navy	navy	generic
nba	nba	generic
nec	nec	generic
netbank	netbank	generic
netflix	netflix	generic
net	net	generic
network	network	generic
neustar	neustar	generic
new	new	generic
news	news	generic
nextdirect	nextdirect	generic
next	next	generic
nexus	nexus	generic
nfl	nfl	generic
ngo	ngo	generic
nhk	nhk	generic
nico	nico	generic
nike	nike	generic
nikon	nikon	generic
ninja	ninja	generic
nissan	nissan	generic
nissay	nissay	generic
nokia	nokia	generic
northwesternmutual	northwesternmutual	generic
norton	norton	generic
now	now	generic
nowruz	nowruz	generic
nowtv	nowtv	generic
nra	nra	generic
nrw	nrw	generic
ntt	ntt	generic
nyc	nyc	generic
obi	obi	generic
observer	observer	generic
office	office	generic
okinawa	okinawa	generic
olayangroup	olayangroup	generic
olayan	olayan	generic
oldnavy	oldnavy	generic
ollo	ollo	generic
omega	omega	generic
one	one	generic
ong	ong	generic
online	online	generic
onl	onl	generic
ooo	ooo	generic
open	open	generic
oracle	oracle	generic
orange	orange	generic
organic	organic	generic
org	org	generic
origins	origins	generic
osaka	osaka	generic
otsuka	otsuka	generic
ott	ott	generic
ovh	ovh	generic
page	page	generic
panasonic	panasonic	generic
paris	paris	generic
pars	pars	generic
partners	partners	generic
parts	parts	generic
party	party	generic
passagens	passagens	generic
pay	pay	generic
pccw	pccw	generic
pet	pet	generic
pfizer	pfizer	generic
pharmacy	pharmacy	generic
phd	phd	generic
philips	philips	generic
phone	phone	generic
photography	photography	generic
photo	photo	generic
photos	photos	generic
physio	physio	generic
pics	pics	generic
pictet	pictet	generic
pictures	pictures	generic
pid	pid	generic
ping	ping	generic
pink	pink	generic
pin	pin	generic
pioneer	pioneer	generic
pizza	pizza	generic
place	place	generic
play	play	generic
playstation	playstation	generic
plumbing	plumbing	generic
plus	plus	generic
pnc	pnc	generic
pohl	pohl	generic
poker	poker	generic
politie	politie	generic
porn	porn	generic
pramerica	pramerica	generic
praxi	praxi	generic
press	press	generic
prime	prime	generic
prod	prod	generic
productions	productions	generic
prof	prof	generic
progressive	progressive	generic
promo	promo	generic
properties	properties	generic
property	property	generic
protection	protection	generic
prudential	prudential	generic
pru	pru	generic
pub	pub	generic
pwc	pwc	generic
qpon	qpon	generic
quebec	quebec	generic
quest	quest	generic
racing	racing	generic
radio	radio	generic
read	read	generic
realestate	realestate	generic
realtor	realtor	generic
realty	realty	generic
recipes	recipes	generic
red	red	generic
redstone	redstone	generic
redumbrella	redumbrella	generic
rehab	rehab	generic
reisen	reisen	generic
reise	reise	generic
reit	reit	generic
reliance	reliance	generic
ren	ren	generic
rentals	rentals	generic
rent	rent	generic
repair	repair	generic
report	report	generic
republican	republican	generic
restaurant	restaurant	generic
rest	rest	generic
review	review	generic
reviews	reviews	generic
rexroth	rexroth	generic
richardli	richardli	generic
rich	rich	generic
ricoh	ricoh	generic
ril	ril	generic
rio	rio	generic
rip	rip	generic
rocher	rocher	generic
rocks	rocks	generic
rodeo	rodeo	generic
rogers	rogers	generic
room	room	generic
rsvp	rsvp	generic
rugby	rugby	generic
ruhr	ruhr	generic
run	run	generic
rwe	rwe	generic
ryukyu	ryukyu	generic
saarland	saarland	generic
safe	safe	generic
safety	safety	generic
sakura	sakura	generic
sale	sale	generic
salon	salon	generic
samsclub	samsclub	generic
samsung	samsung	generic
sandvikcoromant	sandvikcoromant	generic
sandvik	sandvik	generic
sanofi	sanofi	generic
sap	sap	generic
sarl	sarl	generic
sas	sas	generic
save	save	generic
saxo	saxo	generic
sbi	sbi	generic
sbs	sbs	generic
sca	sca	generic
scb	scb	generic
schaeffler	schaeffler	generic
schmidt	schmidt	generic
scholarships	scholarships	generic
school	school	generic
schule	schule	generic
schwarz	schwarz	generic
science	science	generic
scot	scot	generic
search	search	generic
seat	seat	generic
secure	secure	generic
security	security	generic
seek	seek	generic
select	select	generic
sener	sener	generic
services	services	generic
seven	seven	generic
sew	sew	generic
sex	sex	generic
sexy	sexy	generic
sfr	sfr	generic
shangrila	shangrila	generic
sharp	sharp	generic
shaw	shaw	generic
shell	shell	generic
shia	shia	generic
shiksha	shiksha	generic
shoes	shoes	generic
shopping	shopping	generic
shop	shop	generic
shouji	shouji	generic
show	show	generic
showtime	showtime	generic
silk	silk	generic
sina	sina	generic
singles	singles	generic
site	site	generic
skin	skin	generic
ski	ski	generic
skype	skype	generic
sky	sky	generic
sling	sling	generic
smart	smart	generic
smile	smile	generic
sncf	sncf	generic
soccer	soccer	generic
social	social	generic
softbank	softbank	generic
software	software	generic
sohu	sohu	generic
solar	solar	generic
solutions	solutions	generic
song	song	generic
sony	sony	generic
soy	soy	generic
space	space	generic
spa	spa	generic
sport	sport	generic
spot	spot	generic
srl	srl	generic
stada	stada	generic
staples	staples	generic
star	star	generic
statebank	statebank	generic
statefarm	statefarm	generic
stcgroup	stcgroup	generic
stc	stc	generic
stockholm	stockholm	generic
storage	storage	generic
store	store	generic
stream	stream	generic
studio	studio	generic
study	study	generic
style	style	generic
sucks	sucks	generic
supplies	supplies	generic
supply	supply	generic
support	support	generic
surf	surf	generic
surgery	surgery	generic
suzuki	suzuki	generic
swatch	swatch	generic
swiss	swiss	generic
sydney	sydney	generic
systems	systems	generic
tab	tab	generic
taipei	taipei	generic
talk	talk	generic
taobao	taobao	generic
target	target	generic
tatamotors	tatamotors	generic
tatar	tatar	generic
tattoo	tattoo	generic
taxi	taxi	generic
tax	tax	generic
tci	tci	generic
tdk	tdk	generic
team	team	generic
technology	technology	generic
tech	tech	generic
temasek	temasek	generic
tennis	tennis	generic
teva	teva	generic
thd	thd	generic
theater	theater	generic
theatre	theatre	generic
tiaa	tiaa	generic
tickets	tickets	generic
tienda	tienda	generic
tiffany	tiffany	generic
tips	tips	generic
tires	tires	generic
tirol	tirol	generic
tjmaxx	tjmaxx	generic
tjx	tjx	generic
tkmaxx	tkmaxx	generic
tmall	tmall	generic
today	today	generic
tokyo	tokyo	generic
tools	tools	generic
top	top	generic
toray	toray	generic
toshiba	toshiba	generic
total	total	generic
tours	tours	generic
town	town	generic
toyota	toyota	generic
toys	toys	generic
trade	trade	generic
trading	trading	generic
training	training	generic
travelchannel	travelchannel	generic
travelersinsurance	travelersinsurance	generic
travelers	travelers	generic
trust	trust	generic
trv	trv	generic
tube	tube	generic
tui	tui	generic
tunes	tunes	generic
tushu	tushu	generic
tvs	tvs	generic
ubank	ubank	generic
ubs	ubs	generic
unicom	unicom	generic
university	university	generic
uno	uno	generic
uol	uol	generic
ups	ups	generic
vacations	vacations	generic
vana	vana	generic
vanguard	vanguard	generic
vegas	vegas	generic
ventures	ventures	generic
verisign	verisign	generic
versicherung	versicherung	generic
vet	vet	generic
viajes	viajes	generic
video	video	generic
vig	vig	generic
viking	viking	generic
villas	villas	generic
vin	vin	generic
vip	vip	generic
virgin	virgin	generic
visa	visa	generic
vision	vision	generic
viva	viva	generic
vivo	vivo	generic
vlaanderen	vlaanderen	generic
vodka	vodka	generic
volkswagen	volkswagen	generic
volvo	volvo	generic
vote	vote	generic
voting	voting	generic
voto	voto	generic
voyage	voyage	generic
vuelos	vuelos	generic
wales	wales	generic
walmart	walmart	generic
walter	walter	generic
wanggou	wanggou	generic
wang	wang	generic
watches	watches	generic
watch	watch	generic
weatherchannel	weatherchannel	generic
weather	weather	generic
webcam	webcam	generic
weber	weber	generic
website	website	generic
wedding	wedding	generic
wed	wed	generic
weibo	weibo	generic
weir	weir	generic
whoswho	whoswho	generic
wien	wien	generic
wiki	wiki	generic
williamhill	williamhill	generic
windows	windows	generic
wine	wine	generic
winners	winners	generic
win	win	generic
wme	wme	generic
wolterskluwer	wolterskluwer	generic
woodside	woodside	generic
works	works	generic
work	work	generic
world	world	generic
wow	wow	generic
wtc	wtc	generic
wtf	wtf	generic
xbox	xbox	generic
xerox	xerox	generic
xfinity	xfinity	generic
xihuan	xihuan	generic
xin	xin	generic
xn--11b4c3d	कॉम	generic
xn--1ck2e1b	セール	generic
xn--1qqw23a	佛山	generic
xn--30rr7y	慈善	generic
xn--3bst00m	集团	generic
xn--3ds443g	在线	generic
xn--3pxu8k	点看	generic
xn--42c2d9a	คอม	generic
xn--45q11c	八卦	generic
xn--4gbrim	موقع	generic
xn--55qw42g	公益	generic
xn--55qx5d	公司	generic
xn--5su34j936bgsg	香格里拉	generic
xn--5tzm5g	网站	generic
xn--6frz82g	移动	generic
xn--6qq986b3xl	我爱你	generic
xn--80adxhks	москва	generic
xn--80aqecdr1a	католик	generic
xn--80asehdb	онлайн	generic
xn--80aswg	сайт	generic
xn--8y0a063a	联通	generic
xn--9dbq2a	קום	generic
xn--9et52u	时尚	generic
xn--9krt00a	微博	generic
xn--b4w605ferd	淡马锡	generic
xn--bck1b9a5dre4c	ファッション	generic
xn--c1avg	орг	generic
xn--c2br7g	नेट	generic
xn--cck2b3b	ストア	generic
xn--cckwcxetd	アマゾン	generic
xn--cg4bki	삼성	generic
xn--czr694b	商标	generic
xn--czrs0t	商店	generic
xn--czru2d	商城	generic
xn--d1acj3b	дети	generic
xn--eckvdtc9d	ポイント	generic
xn--efvy88h	新闻	generic
xn--fct429k	家電	generic
xn--fhbei	كوم	generic
xn--fiq228c5hs	中文网	generic
xn--fiq64b	中信	generic
xn--fjq720a	娱乐	generic
xn--flw351e	谷歌	generic
xn--fzys8d69uvgm	電訊盈科	generic
xn--g2xx48c	购物	generic
xn--gckr3f0f	クラウド	generic
xn--gk3at1e	通販	generic
xn--hxt814e	网店	generic
xn--i1b6b1a6a2e	संगठन	generic
xn--imr513n	餐厅	generic
xn--io0a7i	网络	generic
xn--j1aef	ком	generic
xn--jlq480n2rg	亚马逊	generic
xn--jvr189m	食品	generic
xn--kcrx77d1x4a	飞利浦	generic
xn--kput3i	手机	generic
xn--mgba3a3ejt	ارامكو	generic
xn--mgba7c0bbn0a	العليان	generic
xn--mgbaakc7dvf	اتصالات	generic
xn--mgbab2bd	بازار	generic
xn--mgbca7dzdo	ابوظبي	generic
xn--mgbi4ecexp	كاثوليك	generic
xn--mgbt3dhd	همراه	generic
xn--mk1bu44c	닷컴	generic
xn--mxtq1m	政府	generic
xn--ngbc5azd	شبكة	generic
xn--ngbe9e0a	بيتك	generic
xn--ngbrx	عرب	generic
xn--nqv7fs00ema	组织机构	generic
xn--nqv7f	机构	generic
xn--nyqy26a	健康	generic
xn--otu796d	招聘	generic
xn--p1acf	рус	generic
xn--pssy2u	大拿	generic
xn--q9jyb4c	みんな	generic
xn--qcka1pmc	グーグル	generic
xn--rhqv96g	世界	generic
xn--rovu88b	書籍	generic
xn--ses554g	网址	generic
xn--t60b56a	닷넷	generic
xn--tckwe	コム	generic
xn--tiq49xqyj	天主教	generic
xn--unup4y	游戏	generic
xn--vermgensberater-ctb	vermögensberater	generic
xn--vermgensberatung-pwb	vermögensberatung	generic
xn--vhquv	企业	generic
xn--vuq861b	信息	generic
xn--w4r85el8fhu5dnra	嘉里大酒店	generic
xn--w4rs40l	嘉里	generic
xn--xhq521b	广东	generic
xn--zfr164b	政务	generic
xyz	xyz	generic
yachts	yachts	generic
yahoo	yahoo	generic
yamaxun	yamaxun	generic
yandex	yandex	generic
yodobashi	yodobashi	generic
yoga	yoga	generic
yokohama	yokohama	generic
youtube	youtube	generic
you	you	generic
yun	yun	generic
zappos	zappos	generic
zara	zara	generic
zero	zero	generic
zip	zip	generic
zone	zone	generic
zuerich	zuerich	generic
