ac	ac	country-code
ad	ad	country-code
ae	ae	country-code
af	af	country-code
ag	ag	country-code
ai	ai	country-code
al	al	country-code
am	am	country-code
ao	ao	country-code
aq	aq	country-code
ar	ar	country-code
as	as	country-code
at	at	country-code
au	au	country-code
aw	aw	country-code
ax	ax	country-code
az	az	country-code
ba	ba	country-code
bb	bb	country-code
bd	bd	country-code
be	be	country-code
bf	bf	country-code
bg	bg	country-code
bh	bh	country-code
bi	bi	country-code
bj	bj	country-code
bm	bm	country-code
bn	bn	country-code
bo	bo	country-code
br	br	country-code
bs	bs	country-code
bt	bt	country-code
bv	bv	country-code
bw	bw	country-code
by	by	country-code
bz	bz	country-code
ca	ca	country-code
cc	cc	country-code
cd	cd	country-code
cf	cf	country-code
cg	cg	country-code
ch	ch	country-code
ci	ci	country-code
ck	ck	country-code
cl	cl	country-code
cm	cm	country-code
cn	cn	country-code
co	co	country-code
cr	cr	country-code
cu	cu	country-code
cv	cv	country-code
cw	cw	country-code
cx	cx	country-code
cy	cy	country-code
cz	cz	country-code
de	de	country-code
dj	dj	country-code
dk	dk	country-code
dm	dm	country-code
do	do	country-code
dz	dz	country-code
ec	ec	country-code
ee	ee	country-code
eg	eg	country-code
er	er	country-code
es	es	country-code
et	et	country-code
eu	eu	country-code
fi	fi	country-code
fj	fj	country-code
fk	fk	country-code
fm	fm	country-code
fo	fo	country-code
fr	fr	country-code
ga	ga	country-code
gb	gb	country-code
gd	gd	country-code
ge	ge	country-code
gf	gf	country-code
gg	gg	country-code
gh	gh	country-code
gi	gi	country-code
gl	gl	country-code
gm	gm	country-code
gn	gn	country-code
gp	gp	country-code
gq	gq	country-code
gr	gr	country-code
gs	gs	country-code
gt	gt	country-code
gu	gu	country-code
gw	gw	country-code
gy	gy	country-code
hk	hk	country-code
hm	hm	country-code
hn	hn	country-code
hr	hr	country-code
ht	ht	country-code
hu	hu	country-code
id	id	country-code
ie	ie	country-code
il	il	country-code
im	im	country-code
in	in	country-code
io	io	country-code
iq	iq	country-code
ir	ir	country-code
is	is	country-code
it	it	country-code
je	je	country-code
jm	jm	country-code
jo	jo	country-code
jp	jp	country-code
ke	ke	country-code
kg	kg	country-code
kh	kh	country-code
ki	ki	country-code
km	km	country-code
kn	kn	country-code
kp	kp	country-code
kr	kr	country-code
kw	kw	country-code
ky	ky	country-code
kz	kz	country-code
la	la	country-code
lb	lb	country-code
lc	lc	country-code
li	li	country-code
lk	lk	country-code
lr	lr	country-code
ls	ls	country-code
lt	lt	country-code
lu	lu	country-code
lv	lv	country-code
ly	ly	country-code
ma	ma	country-code
mc	mc	country-code
md	md	country-code
me	me	country-code
mg	mg	country-code
mh	mh	country-code
mk	mk	country-code
ml	ml	country-code
mm	mm	country-code
mn	mn	country-code
mo	mo	country-code
mp	mp	country-code
mq	mq	country-code
mr	mr	country-code
ms	ms	country-code
mt	mt	country-code
mu	mu	country-code
mv	mv	country-code
mw	mw	country-code
mx	mx	country-code
my	my	country-code
mz	mz	country-code
na	na	country-code
nc	nc	country-code
ne	ne	country-code
nf	nf	country-code
ng	ng	country-code
ni	ni	country-code
nl	nl	country-code
no	no	country-code
np	np	country-code
nr	nr	country-code
nu	nu	country-code
nz	nz	country-code
om	om	country-code
pa	pa	country-code
pe	pe	country-code
pf	pf	country-code
pg	pg	country-code
ph	ph	country-code
pk	pk	country-code
pl	pl	country-code
pm	pm	country-code
pn	pn	country-code
pr	pr	country-code
ps	ps	country-code
pt	pt	country-code
pw	pw	country-code
py	py	country-code
qa	qa	country-code
re	re	country-code
ro	ro	country-code
rs	rs	country-code
ru	ru	country-code
rw	rw	country-code
sa	sa	country-code
sb	sb	country-code
sc	sc	country-code
sd	sd	country-code
se	se	country-code
sg	sg	country-code
sh	sh	country-code
si	si	country-code
sj	sj	country-code
sk	sk	country-code
sl	sl	country-code
sm	sm	country-code
sn	sn	country-code
so	so	country-code
sr	sr	country-code
ss	ss	country-code
st	st	country-code
su	su	country-code
sv	sv	country-code
sx	sx	country-code
sy	sy	country-code
sz	sz	country-code
tc	tc	country-code
td	td	country-code
tf	tf	country-code
tg	tg	country-code
th	th	country-code
tj	tj	country-code
tk	tk	country-code
tl	tl	country-code
tm	tm	country-code
tn	tn	country-code
to	to	country-code
tr	tr	country-code
tt	tt	country-code
tv	tv	country-code
tw	tw	country-code
tz	tz	country-code
ua	ua	country-code
ug	ug	country-code
uk	uk	country-code
us	us	country-code
uy	uy	country-code
uz	uz	country-code
va	va	country-code
vc	vc	country-code
ve	ve	country-code
vg	vg	country-code
vi	vi	country-code
vn	vn	country-code
vu	vu	country-code
wf	wf	country-code
ws	ws	country-code
xn--2scrj9c	ಭಾರತ	country-code
xn--3e0b707e	한국	country-code
xn--3hcrj9c	ଭାରତ	country-code
xn--45br5cyl	ভাৰত	country-code
xn--45brj9c	ভারত	country-code
xn--4dbrk0ce	ישראל	country-code
xn--54b7fta0cc	বাংলা	country-code
xn--80ao21a	қаз	country-code
xn--90a3ac	срб	country-code
xn--90ae	бг	country-code
xn--90ais	бел	country-code
xn--clchc0ea0b2g2a9gcd	சிங்கப்பூர்	country-code
xn--d1alf	мкд	country-code
xn--e1a4c	ею	country-code
xn--fiqs8s	中国	country-code
xn--fiqz9s	中國	country-code
xn--fpcrj9c3d	భారత్	country-code
xn--fzc2c9e2c	ලංකා	country-code
xn--gecrj9c	ભારત	country-code
xn--h2breg3eve	भारतम्	country-code
xn--h2brj9c8c	भारोत	country-code
xn--h2brj9c	भारत	country-code
xn--j1amh	укр	country-code
xn--j6w193g	香港	country-code
xn--kprw13d	台湾	country-code
xn--kpry57d	台灣	country-code
xn--l1acc	мон	country-code
xn--lgbbat1ad8j	الجزائر	country-code
xn--mgb9awbf	عمان	country-code
xn--mgba3a4f16a	ایران	country-code
xn--mgbaam7a8h	امارات	country-code
xn--mgbah1a3hjkrd	موريتانيا	country-code
xn--mgbai9azgqp6j	پاکستان	country-code
xn--mgbayh7gpa	الاردن	country-code
xn--mgbbh1a71e	بھارت	country-code
xn--mgbbh1a	بارت	country-code
xn--mgbc0a9azcg	المغرب	country-code
xn--mgbcpq6gpa1a	البحرين	country-code
xn--mgberp4a5d4ar	السعودية	country-code
xn--mgbgu82a	ڀارت	country-code
xn--mgbpl2fh	سودان	country-code
xn--mgbtx2b	عراق	country-code
xn--mgbx4cd0ab	مليسيا	country-code
xn--mix891f	澳門	country-code
xn--node	გე	country-code
xn--o3cw4h	ไทย	country-code
xn--ogbpf8fl	سورية	country-code
xn--p1ai	рф	country-code
xn--pgbs0dh	تونس	country-code
xn--q7ce6a	ລາວ	country-code
xn--qxa6a	ευ	country-code
xn--qxam	ελ	country-code
xn--rvc1e0am3e	ഭാരതം	country-code
xn--s9brj9c	ਭਾਰਤ	country-code
xn--wgbh1c	مصر	country-code
xn--wgbl6a	قطر	country-code
xn--xkc2al3hye2a	இலங்கை	country-code
xn--xkc2dl3a5ee0h	இந்தியா	country-code
xn--y9a3aq	հայ	country-code
xn--yfro4i67o	新加坡	country-code
xn--ygbi2ammx	فلسطين	country-code
ye	ye	country-code
yt	yt	country-code
za	za	country-code
zm	zm	country-code
zw	zw	country-code
